11111111
1FFF1001
1FF10001
1F110001
11100001
